2 1 1 1 1 3 2
3 1 1 1 3 3 4
4 1 1 1 5 3 6
2 1 1 1 5 3 6
3 1 1 1 3 3 4
4 1 1 1 5 3 6
3 1 1 1 3 3 4
4 1 1 1 5 3 6
2 1 1 1 5 3 6